11 9
# . . . . # # . #
# . # # . # # . #
# . . # E . . . #
# . # # # # # . .
# . # . . . . . #
# . # . # . # # #
. . . . # # # . .
# . # . # . . . #
# . # . # . # # #
# . # . . . . . S
# # # # # # # # #